1111111111111111111
1P0C0111000011110C1
1000000000000100011
1C00110111110001111
10111C0000000000011
1011111110000100111
100011100C001100011
1000010011101011011
110C01C1111001E0001
1111111111111111111