1111111
1P0C0C1
1000001
1C00E01
1111111