1111111
1P0C001
10000C1
1C00E01
1111111