1111111111111111111111111111
1P10000000000111000000000001
1011010000001110000000000001
1000011100000111111100000001
1000000000000100000000000001
1000001000C0011100000C000001
1000001000000100000000000001
1000000000000100000000000001
1000001000000111111100000001
1000001000000010000000000001
100000100E000010000000111001
10000010000000000000000C1001
10000010C0000000C00000111C01
1111111111111111111111111111